11111111111
11100010041
11101010111
12101010111
10001010111
11101000051
11111111111